//board grid 0=no tile 1=tile 2=mc 3=coin 4=ghost 5=box	 
0000555555550000
0000533334150000
0000531551150000
0000531511150000
5555531511155555
5411511115551335
5311555112151145
5311113331151115
5315111111155515
5315515555111135
5333311115133335
5555511555155555
0000531511150000
0000531554150000
0000531131150000
0000555555550000