//board grid 0=no tile 1=tile 2=mc 3=coin 4=ghost 5=box	 
0000555555550000
0000533334150000
0000531551150000
0000531511550000
5555531551155555
5451331115151335
5351555512151335
5351513335113315
5353313151155515
5351553555151535
5333313115133335
5555513555155555
0000533511150000
0000533554150000
0000533333350000
0000555555550000